                                
                                
                                
 ########        ###############
 #      #        #             #
 #      #        #             #
 #      #        #             #
 ###### #   ######             #
      # #   #                  #
      # ##### ####             #
      #       #  #             #
      # ##### #  #             #
      # #   # #  #             #
      # #   # #  #             #
      # # ### #  ######    #####
      # # #   #  #             #
      # # #   #  #             #
      # ###   #  #             #
      #       #  #             #
      #####   #  #             #
          #   #  #             #
          #   #  #             #
          #####  #             #
                 #             #
                 #             #
                 #             #
                 #             #
                 #             #
                 #             #
                 #             #
                 #             #
                 ###############
