
=== END HEADER DATA ===
##################################
########################   #######
######################## #########
########################     #####
############################ #####
#######      #######    #### #####
#######      ##########      #####
#######      #    ##### #### #####
####         # ######## ##      ##
#### ##      # ######## ## #### ##
#### ##      #      ### ## ##   ##
#### ##      ######     ## ## # ##
#    ############## ###### ## # ##
# ## ########## ### ###### ####   
# ## ########## ### ###### ##### #
# ## ########## ##          ######
# ##     ###### ####### ### ######
##### ##     ## ####### ###      #
##### ## ###    #       ######## #
##### ## ######## ############## #
##### ## ########    #####       #
##### ## #################  ###  #
#####         #######            #
############  #######  ###########
###           ####     ###########
##########  ######  ##############
####        ######            ####
####  ####  ######  ########  ####
####  ####  ######  ########  ####
####  ####  ######  ########  ####
####  ####  ######  ########  ####
####  ####  ######  ########  ####
####  ####  ######  ########  ####
####  ####  ######  ########  ####
####  ####  ######  ########  ####
####  ######################  ####
####                          ####
##################################