
=== END HEADER DATA ===
#######################   #######
####################### #########
#######################     #####
########################### #####
######      #######    #### #####
######      ##########      #####
######      #    ##### #### #####
###         # ######## ##      ##
### ##      # ######## ## #### ##
### ##      #      ### ## ##   ##
### ##      ######     ## ## # ##
    ############## ###### ## # ##
 ## ########## ### ###### ####   
 ## ########## ### ###### ##### #
 ## ########## ##          ######
 ##     ###### ####### ### ######
#### ##     ## ####### ###      #
#### ## ###    #       ######## #
#### ## ######## ############## #
####    ########    #####       #
####    #################  ###  #
####                            #
#################################
